Z9_mA_pEl_klod	Je mÅfappelle Claude 
A_l0_Ze_l9_kO_RE_mOR	Allonge le corps est mort 
puR_de_mi_lje	Pour des milliers 
se_tU_nOm_ki_n9_dOR_pA_	C'est un homme qui ne dort pas 
A_mwA_tje_plE_nE_la_fOR	A moitie pleine est l'amphore 
k0_lA_vwA_sa_ze_fE	Qu'on la voit sans effet 
vwAR_lA_vi_s0_ko_te_pil	Voir la vie son cote pile 
O_fi_lo_zo_fi	Oh philosophie 
di_lHi_de_ze_le_Zi	Dis-lui des elegies 
l2_bO_n9_REl_m9_fE_p9R	Le bonheur Elle me fait peur
dA_vwAR_ta_da_vi	D'avoir tant d'envies 
mwA_ZE_U_su_flA_k9R	Moi j'ai un souffle a c?ur 
sE_tyn_bEl_ZuR_ne	C'est une belle journee 
Z2_vE_m2_ku_Se	Je vais me coucher 
il_diz_k0_mAs_k9_no_p9R	Ils disent quÅfon masque nos peurs 
0_RA_sy_Re_0_su_Ri	On rassure et on sourit 
il_n2_fo_pA_k0_nu_bli	Il ne faut pas qu'on oublie 
l9_bo_ta_A_pRE_lA_plHi	Le beau temps apres la pluie 
e_kEs_k0_fE	Et qu'est qu'on fait ? 
ty_pRa_dRA_l9_pRo_SU	Tu prendras le prochain 
U_tA_kos_tRwA_vjad	Un tacos trois viande 
syR_lo_tR2_kE	Sur l'autre quai 
no_kOR_se_gRa_vwA_jA_Z9R	Nos corps ces grands voyageurs 
vo_sot_dy_m9R	Vos sautes d'humeurs 
vRE_ma_sa_zA_RE	Vraiment sans arret 
0_so_vlA_po_d2_luRs_	On sauve la peau de l'ours 
A_va_d2_lA_vwAR_tHe	Avant de l'avoir tue 
Z9_R2_si_kl2_le_m9bl	Je recycle les meubles 
e_va_lA_mE_z0	Et vends la maison 
puR_mE_tRU_no_tEl	Pour mettre un hotel 
Ry_d2_lA_pE	rue de la paix 
U_m0_du_tu_lm0d_sE_m2_RE	Un monde ou tout lÅfmonde s'aimerait 
ZA_SE_tU_SA_to_a_nEs_pAJ	J'achete un chateau en Espagne 
da_s0_nE_spRi_ki_di_vAg	Dans son esprit qui divague 
Z2_m9_pER_da_te_Zj2	Je me perds dans tes yeux 
Z2_m2_nwA_da_lA_vAg	Je me noie dans la vague 
d2_t0_R2_gA_RA_mu_R2	De ton regard amoureux 
Z2_n2_v2_k2_t0_nAm	Je ne veux que ton ame  
di_vA_ga_syR_mA_po	Divaguant sur ma peau 
Z2_n2_sHi_k2_t0_n0bR	Je ne suis que ton ombre 
l2_su_fl2_la_si_na	Le souffle lancinant 
A_ni_me_la_t2_ma	Animes lentement 
Z2_Re_zO_na_bE_ze	Je raisonne en baisers 
l2_l0_d2_tA_pwA_tRin	Le long de ta poitrine 
pER_dy_da_lA_vA_laS	Perdu dans l'avalanche 
ki_E_ty	Qui es-tu ? 
u_e_ty	Ou es-tu ? 
fOR_mA_tle_sa_ti_ma	Formate les sentiments 
mE_Zi_mA_Zin_kyn_mA_Sin	Mais j'imagine qu'une machine 
n2_p2_k2_fER_sa_bla	Ne peut que faire semblant 
tRwA_mwU_zU_fE_d2	Trois moins un fait deux 
kA_tR9_vU_diz_n9f	Quatre vingt dix neuf 
l2_p0_dy_so_lEj	Le pont du soleil 
bHi_s0_d2_ka_pAJ	Buisson de campagne 
Jo_ki_A_lA_Ri_ko_tA	Gnocchis a la ricotta 
stRo_bos_ko_pik	Stroboscopique 
pU_o_So_ko_lA_	Pain au chocolat 
SO_ko_lA_ti_nAb_sta_sj0	Chocolatine Abstention 
lA_bAl_R0d	La balle ronde 
StRuv_pA_tA_mE_z0	jÅftrouve pas ta maison 
sEt_plys_tRwA_f0_dis	sept plus trois font dix 
kaZ_R2_vjU_dRE	Quand jÅfreviendrai 
le_SjU_SE_bjU	Les chiens cÅfest bien 
dE_J2_RA_til_k0_te_le_ZuR	Daignera-t-il compter les jours 
Ab_do_mi_no_Al_bA_tOR	Abdominaux  Albator 
kAZ_bAl_fu_tAd_bo_dU_d0	Cage balle foot Ta dÅfbeau dindons
kAl_pORt_so_lEj_sjEl	Cale porte Soleil ciel
gAJ_pU_As_mA_tik	Gagne pain Asmathique  
tA_bl9_d2_bAR_VEj_tAR_s2_swAR	Table de bar Veille tard ce soir
l2_zwAv_kRwA_U_dZOb_mOS	Le zouave crois un job moche
gAJ_l2_pAR_bRiz	Gagne le pare brise 
AS_p2_pAl_sHi_vRo_lwU	Ah jÅfpeux pas lÅfsuivre au loin 
il_kHi_lA_tRHit	Il cuit la truite 
it_fE_fER_k2_dy_bRHi	Y tÅffais faire que du bruit 
lAk_t9_RE_svElt	LÅfacteur est svelte 
dUd_fARs_gRi_je	Dinde Farce Grille 
tAb_gAb_SA	Tab Gab Chat 
tOR_fREd_SA	Thor Fred Chat 
dAl_va_AS_tRwA_	Dalle vent hache trois 
gAb_Zu_A_lA_k0_sOl	Gab joue a la console 
il_tAp_kEl_kU	Il tape quelquÅfun 
bAz_s2_kREt	Base secrete 
maZ_da_t0_nA_sjEt	Mange dans ton assiette 
gAb_kul_tOm_nAZ_bRHid_ku_lwAR	Gab coule Tom nage Bruit dÅfcouloir 
yn_kuRb_fin	Une courbe fine 
tu_bib_ze_bRe	toubib zebre 
kuRb_Jo_ki	Courbe Gnocchis 
t0b_te_bAl	Tombent tes balles 
gAb_nHi_zibl	Gab nuisible
kuRb_vi_tAl_gA_lOp	courbe vitale galope 
bad_gE_nat_mA_Rat	bande gainante marrante 
bad_ze_bRe_pRe_fe_Re	bande zebree preferee 
bad_pA_sat_gAf_zU_zo_lU	bande passante gaffe zinzolin 
yn_gRad_Soz_vERt	une grande chose verte 
il_m2_gR0d_mwA	il me gronde moi 
bA_lAd_nOR_mAl	Balade normale 
bAd_tRip_mA_Zik	Bad trip magique 
glad_vi_tAl_ze_bRe	glande vitale zebree 
l2_b9f_bl9f	le boeuf bluff 
dis_po_zi_tif_de_kA_da	dispositif decadent 
lOm_fyR_tif_gAJ	lÅfhomme furtif gagne 
U_pe_RA_tif_Zyk_stA_po_ze	imperatif juxtapose 
fy_Zi_tif_Jo_ki_	fugitif gnocchi 
Ad_Zek_tif_pyl_ve_Ri_zA_sj0	adjectif pulverisation 
U_mEk_fyR_tif_Sat	Un mec furtif chante 
e_fEk_tif_kEl_k0k	Effectif quelconque 
nA_if_mA_ti_nAl	Naif matinal 
fo_tif_no_sif	fautif nocif 
e_mo_tif_te_RjU	Emotif terrien 
spOR_tif_vo_la	Sportif volant 
b9g_b9g_tAg_das	bug bug tag danse 
mAg_mAg_fHi	mag mag fuis 
b9g_Zyp_bAR	bug jupe bar 
mAg_Jo_ki_tag_zEbR	mag gnocchi tangue zebre 
p9g_nU_bul	pug nain boule 
p9g_pAt_bARb	pug pattes barbe 
mAg_vA_dRuj_b9g_sA_le	mag vadrouille bug sale 
bRi_ko_lAZ_fA_sil_fORZ_Jo_ki	bricolage facile Forge Gnocchi 
mAZ_gAZ_gOlf_sAbl	Mage Gage Golf sable 
ty_bwA_lA_ZwA_buZ_zU_zo_lU	tu boit la joie Bouge Zinzolin 
ty_dwA_kwA	tu dois quoi 
yn_fwA_d9_RwA	une foie de roi 
l2_gwo_kA	le gwoka 
Z2_m2_nwA_sa_twA	je me noie sans toi 
l9_bU_sA_a_glOb_tu_se_SwA	Le bain ca englobe tous ces choix 
sE_dlA_bOn	CÅfest dÅfla bonne 
l2_nU_buZ_pAl_vo	le Nain Bouge PAL veau 
A_pEl_Jo_ki_ZEm_pAl_SA	Appel gnocchis jÅfaime PAL chat 
il_fy_tU_be_lje_b0_a_Sa	Il fut un belier bon en chant 
nu_zA_v0_vy_lOm_ny	Nous avons vu lÅfhomme nu 
kAZ_kAZ_mAl	Cage cage mal 
gAZ_nAz_tOZ_voZ	Gage Nage Toge Voges 
bAz_bAz_d0z_fEz_gAR	base base dÅfonze fez gare 
mA_Riz_pEz_tA_vA_liz_mA_R0	Maryse pese ta valise marron 
bAz_SA_bAz_Z2	Base chat base jeu 
kAz_Jo_ki	Case Gnocchis 
gAJ_fAs_nOR_pEJ_byl_	Gagne face Nord peigne bulle 
dEJ_kA_ne_pU_v9f	daigne caner pain veuf 
e_le_fa_b2_do_na	elephant bedonant 
d2_va_lA_Ry	devant la rue 
il_ni_A_ply_d9f	Il nÅfy a plus dÅfoeuf 
A_lA_fU_il_SaZ_d2_ke_pi	a la fin Il change de kepis 
l2_sU_de_pul_vOl	le saint des poules vole 
dy_f2_d2_dj2	Du feu de dieu 
sEJ_kOm_da_l2_film	Saigne comme dans le film 
tA_tat_gAJ_da_ly_ni_vER	ta tante gagne dans lÅfunivers 
pEJ_gER_Syt_vOl	Peigne guerre chute vole 
kAv_bEJ_pAR_Za	Cave baigne par gens 
kOJ_lOR_vu_zyt	Cogne lÅfor vous zut 
pEJ_tAS_tuR_Jo_ki	Peigne tache tour Gnocchis 
bEk_dEJ_Re_y_siR	Bec daigne reussir 
U_RHi_so_gA_la	un ruisseau galant 
pjOS_da_l2_pn2	pioche dans le pneu 
dEJ_mA_Zik_pwAR_go_lwA	Daigne magique poire gaulois 
kREv_SAk_bEJ_vOl	creve chaque baigne vole 
bEJ_ZEm_tak_SA	Baigne jÅfaime tank chat 
ZOb_sERv_s9l_le_za_glE	JÅfobserve seul les anglais 
kOJ_zon_das_d0k_ZwA	Cogne zone danse donc joie 
bEJ_sA_mU_a_bA	baigne sa main en bas 
U_Su_dEJ_Sa_kEl	un chou daigne chant quel 
pAn_pAk_mOS_bEk_vOl	panne paque moche bec vole 
kAs_bAm_gAp_ZwA	casse bam gap joie 
tSEk_gAp_SA	Tcheque gap chat 
gRAv_fAs_ZEm_sA	grave face jÅfaime sa 
gi_bAS_fARs_zEp_gys_SA	Guy bache farce zep gusse chat 
o_ROR_gAm_RU_Ru	Aurore Gamme rein roux 
AS_kAS_gER_zEl	Hache Cache guerre zele 
aS_mEn_sEk_zon_fA_ti_g0	anche mene sec zone fatiguons 
kAj_bAs_fuRS_ZEm_vA	caille basse fourche jÅfaime va 
lAs_fAm_bAs_Jo_ki_a_bwAt	lÅfas femme basse gnocchi en boite 
U_e_Ro_yn_ROb	Un hero une robe 
mAS_vAp_nA_Zo_li	Mache vape nage au lit 
bAm_SOp_duv_maS_Jo_ki	Bam Choppe douve manche gnocchi 
pAn_g9l_kwA_f9_R9f	Panne gueule coiffeur oeuf 
fjol_kuv_ge_pAR_de_klU	Fiole Couve guepard declin 
U_JE_vAS_zu_kuv_zEl	un niais vache zou couve zele 
vAlv_gAm_ZEn_vAS_snOb	Valve gamme genes vache snob 
gRy_SOp_vAlv_dAm_zEl_	grue choppe valve dame zele 
mi_kR0d_be_gU_Syt_sEl	micro-onde begun chute sel 
buS_nEk_nAp_SAt_ZEl	bouche neque nape chatte gele 
kAp_vER_S9m_zEl_my_g2	cap verre cheum zele mue geux
bEk_JE_kAv_tEt_SOp_zo	Bec niais cave tete choppe zoo 
t0_gu_s0_kApt_zon_ZEm_JE	ton gout son capte zone jÅfaime niais 
de_z2_vAn_zEp_tAbl	des oeuf vanne zep table 
kAn_SOp_sEv_dut_n9f_	canne choppe seve doute neuf 
a_dHi_fjAs_ko_pAp_tRuv_Zul	enduis fiasco pape trouve joule 
kROk_mjU_ZHi_jE_kap_Jo_ki	croc miens juillet cap gnocchis 
kAv_n9v_Jo_ki_nAt_kEl	cave neuve gnocchis natte quelle 
kA_ZlE_e_kRe_me_0_p2	Cage lait ecreme on peut 
SHi_bo_jA_pA_A_Re_fle_SiR	Shui beau y a pas a reflechir
vHi_de_l2_bu_j0_sA_ja	Vuider le bouillon saillant 
lA_pwEl_d2_pHi_sas	la poele de puissance 
pjOS_lA_bwe_kO_mlo	Pioche la bouee comme lÅfeau 
lA_tRwA_zjEm_fwA_k2_ZA_kjEs	la Troisieme fois que j'acquiesce 
kA_z9R_kA_lRA_pju_	case eure cale rat piou 
mE_pE_jU_gAg	mais paye un gag 
pE_jyn_vi_fA_sil	paye une vie facile 
ka_ja_nA_ply_ja_nA_a_kOR	Quand yÅfen a plus yÅfen a encore 
kO_dU_Za_pi_RAt	Code un gens pirate 
mE_jo_A_ni_fo	mais yohan y faut 
fo_R2_ko_ma_se	faut recommencer 
il_bu_Za_mAs	ils bougent en masse 
zo_nu_vo_Zo_li_SA	zoo nouveau joli chat 
ka_pA_JAl_mA_JEs_pA_J0d	campagne allemagne espagne onde 
wi_bE_JU_RAz	Oui Beigne un rase 
kO_Ju_mAR_SA_Rwa	Cogne ou marche a Rouen
ka_pA_Ja_vi_Ro_nat	campagne environnante 
U_gi_JO_la_R2_d2_mad	Un Guignol en redemande 
plU_kEl_kU_bO_ta_bwA	Plain quelquÅfun botte en bois 
o_wi_Jo_ki	Oh oui gnocchis 
pRE_gA_Jy_ze_Jo_ki	pret gagne user gnocchis 
b0_gu_ply_gRa_Jo_ki	bon gout plus grand gnocchi 
Zi_pE_Ji_si_U_Ri_U_li	JÅfy peigne ici un riz un lit 
kO_SU_pE_J2_R2_Jo_ki	coche un peigne heureux gnocchis  
pE_J9R_bu_jOR_	Peigne heure bouille or 
tO_Z9_j9_RA_j2_jyp	Toge oeil heure ailleux yupe 
bu_gA_gjo_A_nu_no	bout gag Yohan uno 
0_zHit_bO_su	onze huit bosse ou 
Hit_pE_S0_t0_b0	huit pechons tombons 
bE_nRA_kA_sRiS	benne rat casse riche 
bi_SRA_mi_zRAb	biche rat mise rab 
gA_gHit_kAn_lARZ	gag huit canne large 
gA_mHit_kA_slAv	gamme huit casse lave 
pl0_kA_SlA_gjo_An	plomb cache lag yohan 
kA_tOr_zlA_pluf	quatorze la plouf 
ty_li_po_li_pA_s9_li_si	tulipe polie pas seul ici
Ro_Jo_pa_ZU_Hit	Rot nyo pange un huit
me_da_bHi_Z0_Je	mes dents buis jon nye
pAn_tAw_RAp_fEt_Jo_ki	panne taw Rap fete gnocchis
bEZ_jo_bad_Jo_ki	beige yo bande Gnocchis
O-a-O-U-O	O en O in O
a-a-U-a-0-a	en en in en on en
